{
    "title": "Cellar",
    "startGold": 4000,
    "tileset": "dungeon",
    "route": [
        [ "A", "9" ],
        [ "B", "9" ],
        [ "C", "9" ]
    ],
    "field": [
        "11111111111111111111111111111111",
        "11111111111111111111111111111111",
        "11111111111111111111111111111111",
        "11111111111111111111111111111111",
        "1111BB11111111122211111111111111",
        "11110011111110000000111111111111",
        "1112001000100000000000>000001111",
        "1112000000000000100000>001000111",
        "111100111000112110022110011VV111",
        "11110001102021112001112001000111",
        "11110001100022122001100001110111",
        "11A00000001000100000000100333111",
        "11A00110001000000110001100393111",
        "11A00000001000100000000100333111",
        "11110001100022122001100001110111",
        "11110001102021112001112001000111",
        "111100111000112110022110011^^111",
        "1112000000000000100000>001000111",
        "1112001000100000000000>000001111",
        "11110011111110000000111111111111",
        "1111CC11111111122211111111111111",
        "11111111111111111111111111111111",
        "11111111111111111111111111111111",
        "11111111111111111111111111111111",
        "11111111111111111111111111111111"
    ]
}