{
    "title": "Gridlock",
    "startGold": 1700,
    "tileset": "mines",
    "route": [
        [ "A", "9" ],
        [ "B", "9" ],
        [ "C", "9" ],
        [ "D", "9" ],
    ],
    "field": [
        "11111111111111111111111",
        "11111111111111111111111",
        "11111111111111111111111",
        "111111111111111111B1111",
        "111C0000000060006001111",
        "11110111111161016101111",
        "11110166666661006101111",
        "111101611111V1016101111",
        "11110161003331016101111",
        "11110161013931016101111",
        "11110161013330016101111",
        "1111016101^111116101111",
        "11110160016666666101111",
        "11110161016111111101111",
        "1111006000600000000D111",
        "1111A111111111111111111",
        "11111111111111111111111",
        "11111111111111111111111",
        "11111111111111111111111",
        "11111111111111111111111",
        "11111111111111111111111",
        
    ],
    "rails": [
        {"startRow": 5, "startCol": 6, "endRow": 17, "endCol": 12, "interval": 4 },
        {"startRow": 17, "startCol": 16, "endRow": 5, "endCol": 10, "interval": 4 },
        ]
}