{
    "title": "Jumpy",
    "startGold": 10000,
    "tileset": "stone",
    "route": [
        [ "A", "9" ],
        [ "B", "9" ],
        [ "C", "9" ]
    ],
    "field": [
        "111111111111111111111111111111111",
        "111111111111111111111111111111111",
        "1111111111115122211111111511111111",
        "11111111100000000000000000A111111",
        "113331111022222022222202211111111",
        "1139300000000000000000000000B1111",
        "113331115022202220222222211111111",
        "111111111000000000000000000C11111",
        "111111111111111551111111111111111",
        "111111111111111111111111111111111",
        "111111111111111111111111111111111",
        "111111111111111111111111111111111"
        
    ]
    
}