{
    "title": "Killbox",
    "startGold": 1200,
    "tileset": "ash",
    "route": [
        [ "A", "9" ],
        [ "B", "8" ]
    ],
    "field": [
        "111111111111111111111111",
        "111111111111111111111111",
        "111111111111111111111111",
        "11111111111BBB1111111111",
        "111111111110001111111111",
        "111111111110001111111111",
        "111111111110002221111111",
        "111111120000000001111111",
        "111111120110101101111111",
        "111111120100000101111111",
        "1111A0000001010000033311",
        "1111A0000100000100039311",
        "1111A0000001010000033311",
        "111111110100000102111111",
        "111111110110101102111111",
        "111111110000000002111111",
        "111111112220001111111111",
        "111111111110001111111111",
        "111111111113331111111111",
        "111111111113831111111111",
        "111111111113331111111111",
        "111111111111111111111111",
        "111111111111111111111111"
    ]
}