{
    "title": "Temple",
    "startGold": 3000,
    "tileset": "dungeon",
    "route": [
        [ "A", "9" ],
    ],
    "field": [
        
        "1111111111111111111111111111",
        "1111111111111111111111111111",
        "1111111111111AA1111111111111",
        "1111111111111001111111111111",
        "1111111111221001221111111111",
        "1111111100000000000011111111",
        "1111111100000000000011111111",
        "1111111200121001210021111111",
        "1111111200212002120021111111",
        "11111111VV121001210012111111",
        "1111111100000050000000391111",
        "1111111100000500000000331111",
        "11111111VV121001210012111111",
        "1111111200212002120021111111",
        "1111111200121001210021111111",
        "1111111100>000000>0011111111",
        "1111111100>000000>0011111111",
        "1111111111122112211111111111",
        "1111111111111111111111111111",
        "1111111111111111111111111111",
        
        
    ], 
    "decorations": [
    ]
}