{
    "title": "Gold Rush",
    "startGold": 1200,
    "tileset": "mines",
    "route": [
        [ "A", "9" ],
        [ "B", "9" ],
        [ "C", "9" ]
    ],
    "field": [


        "111111111111111111111111111",
        "111111111111111111111111111",
        "111111111111111111111111111",
        "111111111111AAA111111111111",
        "111111111111000111111111111",
        "111111111110010011111111111",
        "111111111666666666111111111",
        "11111111111VV1VV11111111111",
        "111111666666666666666111111",
        "111111611111000111116111111",
        "111111616666666666616111111",
        "111111616111000111616111111",
        "11100060600>333<00606000111",
        "11100060600>393<00606000111",
        "111001616111333111616100111",
        "111BB11111111111111111CC111",
        "111111111111111111111111111",
        "111111111111111111111111111",
        "111111111111111111111111111"

    ],
    "rails": [
        {"startRow": 3, "startCol": 20, "endRow": 3, "endCol": 6, "interval": 3 },
        {"startRow": 3, "startCol": 8, "endRow": 3, "endCol": 18, "interval": 4 },
        {"startRow": 12, "startCol": 18, "endRow": 12, "endCol": 8, "interval": 2 },
        
    ]
}