{
    "title": "The Edge",
    "startGold": 2000,
    "tileset": "ice",
    "route": [
        [ "A", "9" ],
        [ "A", "0", "9" ],
          
    ],
    "field": [
        "11111111111111111111111111111111",
        "11111111111111111111111111111111",
        "11111111111111111111111111111111",
        "1111AA11111111111100000211111111",
        "11110011222211000001110000001111",
        "111200000000>0011111120000001111",
        "111200000000>0011111120111002111",
        "11111111222211000001110111002111",
        "11111111111111222100000211002111",
        "11111111111100000212222111002111",
        "11193<00000001120000000001101111",
        "11133111111100000211111101102111",
        "11111111111111111111111100002111",
        "11111111111111111111111122211111",
        "11111111111111111111111111111111",
        "11111111111111111111111111111111",
        "11111111111111111111111111111111",
                
    ], 
    "decorations": [
    ],
    "checkpoints": {
        "0": 
        [
            "11111111111111111111111111111111",
            "11111111111111111111111111111111",
            "11111111111111111111111111111111",
            "11110011111111111111111111111111",
            "11110011111111111111111111111111",
            "11110011111111111111111111111111",
            "11110000000000011111111111111111",
            "11111111111111000001111111111111",
            "11111111111111111100!11111111111",
            "11111111111111111111111111111111",
            "11111111111111111111111111111111",
            "11111111111111111111111111111111",
            "11111111111111111111111111111111",
            "11111111111111111111111111111111",
            "11111111111111111111111111111111",
            "11111111111111111111111111111111",
            "11111111111111111111111111111111",
        
        ]
    }
}