{
    "title": "Twist",
    "startGold": 2500,
    "tileset": "ice",
    "route": [
        [ "A", "9" ],
        [ "B", "9" ],
    ],
    "field": [
        "111111111111111111111111",
        "111111111111111111111111",
        "1111111WWWWW111111111111",
        "111111000000011111111111",
        "111111011111011111111111",
        "111111010000000001111111",
        "1111110101100001021BBB11",
        "111111010011001102100011",
        "111111010003331002110011",
        "111000000003930000000011",
        "111001120013330001011111",
        "111000120110011001011111",
        "111AAA120100001101011111",
        "111111110000000001011111",
        "111111111111011111011111",
        "111111111111000000011111",
        "1111111111111MMMMM111111",
        "111111111111111111111111",
        "111111111111111111111111",
        "111111111111111111111111"
    ] 
}