{
    "title": "Warehouse",
    "startGold": 1000,
    "tileset": "mines",
    "route": [
        [ "A", "9" ],
    ],
    "field": [
        "11111111111111111111111",
        "11111111111111111111111",
        "11111111111111111111111",
        "11111111111111111111111",
        "11111111111111222111111",
        "11110000100000000111111",
        "11110000100000000111111",
        "11110220000021100111111",
        "11A00220011000000133311",
        "11A00000000000000039311",
        "11A00110100010000133311",
        "11110000100000000111111",
        "11110000001000110111111",
        "11110000000000000111111",
        "11111222211111111111111",
        "11111111111111111111111",
        "11111111111111111111111",
        "11111111111111111111111",
        "11111111111111111111111",
        "11111111111111111111111",
        "11111111111111111111111",
        
    ]
}