{
    "title": "Mines",
    "startGold": 2000,
    "tileset": "mines",
    "route": [
        [ "A", "9" ],
    ],
    "field": [
        "11111111111111111111111",
        "11111111111111111111111",
        "11111111111111111111111",
        "1111110000010>000111111",
        "1110000010000>010211111",
        "11101100100011110211111",
        "11101111111111110216111",
        "1110000A111111110216111",
        "1111100A111111110336111",
        "1110000A110000010396111",
        "11101111110111011116111",
        "11100000066666666666111",
        "11106666660222222111111",
        "11116111111222222221111",
        "11111111111112222222221",
        "11111111111111112222222",
        "11111111111111111111222",
        "11111111111111111111111",
       
        
    ],
    "rails": [
        {"startRow": 12, "startCol": 19, "endRow": 3, "endCol": 4, "interval": 4 },
    ]
}