{
    "title": "Detour",
    "startGold": 2500,
    "tileset": "prison",
    "route": [
        [ "A", "9" ],
        [ "B", "9" ],
        
          
    ],
    "field": [
        "111111111111111111111111111",
        "111111111111111111111111111",
        "111111111111111111111111111",
        "111111111111222111111111111",
        "111111111112222211111111111",
        "111100000000000000000001111",
        "111101011222101222110101111",
        "111101010000000000010101111",
        "111101010111202111010101111",
        "111101020200000002020101111",
        "111121020201101102020121111",
        "111A0102010133310102010B111",
        "111A0000000139310000000B111",
        "111A0102010133310102010B111",
        "111121020201101102020121111",
        "111101020200000002020101111",
        "111101010111202111010101111",
        "111101010000000000010101111",
        "111101011222101222110101111",
        "111100000000000000000001111",
        "111111111112222211111111111",
        "111111111111222111111111111",
        "111111111111111111111111111",
        "111111111111111111111111111",
        "111111111111111111111111111",
                        
    ], 
    "decorations": [
    ]
}