{
    "title": "Station",
    "startGold": 1000,
    "tileset": "mines",
    "route": [
        [ "A", "9" ],
        [ "B", "9" ],
        [ "C", "9" ],
        [ "D", "9" ],
          
    ],
    "field": [
        "111111111111111111111111",
        "111111111111111111111111",
        "111111111111111111111111",
        "111111391111111111111111",
        "116111331111111111111111",
        "116111011111111111111111",
        "11611166666666666666A111",
        "116111011111111111111111",
        "11611166666666666666B111",
        "116111011111111111111111",
        "11611166666666666666C111",
        "116111011111111111111111",
        "11611166666666666666D111",
        "111111111111111111111111",
        "111111111111111111111111",
        "111111111111111111111111",
            
    ],
    "rails": [
        {"startRow": 2, "startCol": 2, "endRow": 12, "endCol": 2, "interval": 7 },
        
    ], 
}