{
    "title": "Chasm",
    "startGold": 2500,
    "tileset": "ice",
    "route": [
        [ "A", "8" ],
        [ "B", "9" ],
        
          
    ],
    "field": [
        "11111111111111111111111111",
        "11111111111111111111111111",
        "11111111111111111111111111",
        "11111111111111111111111111",
        "1111AA11111111111111111111",
        "11110011111111001111113311",
        "11110000111000001011003811",
        "22220000000000000000002222",
        "15222220222222222002222222",
        "22222220222222000022122222",
        "22221100000000000011221111",
        "21111111002211111000222222",
        "111B000000113331111V111112",
        "111B0000111139300000011111",
        "11111111111133311111111111",
        "11111111111111111111111111",
        "11111111111111111111111111",
        "11111111111111111111111111",
        "11111111111111111111111111",
        "11111111111111111111111111",
                        
    ], 
    "decorations": [
        { "type": "Boulder", "row": 9, "col": 6, "rotation": 270 },
        { "type": "Boulder", "row": 6, "col": 20, "rotation": 90 },
        { "type": "Boulder", "row": 13, "col": 17, "rotation": 0 },
    ]
}