{
    "title": "Catacombs",
    "startGold": 1000,
    "tileset": "stone",
    "route": [
        [ "A", "9" ],
        [ "B", "9" ]
    ],
    "field": [
        "11111111111111111111111",
        "11111111111111111111111",
        "11111111111111111111111",
        "11111111111111111111111",
        "11111B11111111111111111",
        "11111011111111111111111",
        "11120001000100010002111",
        "11120000000000000002111",
        "11120001000100010002111",
        "11111011101110111011111",
        "11120001000133310002111",
        "11120000000039300002111",
        "11120001000133310002111",
        "11111011101110111011111",
        "11120001000100010002111",
        "11120000000000000002111",
        "11120001000100010002111",
        "11111111111110111111111",
        "1111111111111A111111111",
        "11111111111111111111111",
        "11111111111111111111111",
        "11111111111111111111111"
    ]
}