{
    "title": "Arena",
    "startGold": 2300,
    "tileset": "ash",
    "route": [
        [ "A", "9" ]
    ],
	"field":[
		"1111111111111111111111111",
		"1111111111111111111111111",
		"1111111111111111111111111",
		"11111111111AAA11111111111",
		"1111111111100011111111111",
		"1111111111100011111111111",
		"1111111111100011111111111",
		"1111111111100011111111111",
		"1111111111000001111111111",
		"1111111100010100011111111",
		"1111111101000001011111111",
		"1111111100000000011111111",
		"1111111000100010001111111",
		"1111110050100010500111111",
		"1111111000100010001111111",
		"1111111100000000011111111",
		"1111111101000001011111111",
		"1111111100010100011111111",
		"1111111111000001111111111",
		"1111111111100011111111111",
		"1111111111133311111111111",
		"1111111111139311111111111",
		"1111111111133311111111111",
		"1111111111111111111111111",
		"1111111111111111111111111",
						
	]
}