{
    "title": "Crumble Zone",
    "startGold": 50000,
    "tileset": "prison",
    "route": [
        [ "A", "9" ],
        [ "B", "9" ],
        [ "C", "7" ],
        [ "A", "8" ]
    ],
    "field": [
        "1111111111111111111111111111111111",
        "1111111001111371222211156511001111",
        "1622222111151331222201106001001221",
        "16222221BB111101111111106111000221",
        "1633312000001102200511106661115221",
        "1639312110000000000000002561110221",
        "1633312115100111111100150266666661",
        "161102211220011111110000021MMMM161",
        "1611022112200111111101010511111161",
        "166661115100011AAA1102220111111161",
        "1111611000005500000666666666661161",
        "2222651011011120010610110111111161",
        "22226010{1011220511610100122233161",
        "11166510{1010000111600101122238061",
        "1116111011010110111610001111111061",
        "111600000000011111111C100101166661",
        "1116111111110100011111100101111011",
        "1111111111110011111111110000000001",
        "1111111111111100011111111111111001",
        "1111111111111111111111111111111111"

    ],
    "rails": [
        { "startRow": 4, "startCol": 19, "endRow": 9, "endCol": 30, "interval": 3 },
        { "startRow": 2, "startCol": 3, "endRow": 18, "endCol": 1, "interval": 2 },
        { "startRow": 4, "startCol": 28, "endRow": 19, "endCol": 24, "interval": 1.5 },
    ]
}