{
    "title": "Mineshaft",
    "startGold": 2000,
    "tileset": "mines",
    "route": [
        [ "A", "0", "9" ],
        [ "B", "9" ],
        
          
    ],
    "field": [
        
        "111111111111222221111",
        "111111111111122211111",
        "111111111111112221111",
        "111111111111611222111",
        "11111111B000611122211",
        "111AA111B000666666211",
        "111001111211011116211",
        "111001111211011666211",
        "111000022210011611111",
        "1110000200>0000666111",
        "1110000200>0000001111",
        "111666010010011101111",
        "111116010011011101111",
        "111116000011011101111",
        "111116666666666666611",
        "111111111111122201111",
        "111111111111111101111",
        "111111111111111333111",
        "111111111111111393111",
        "111111111111111333111",
        "111111111111111111111",
        "111111111111111111111",
                        
    ], 
    "decorations": [
    ],
    "rails": [
        {"startRow": 7, "startCol": 19, "endRow": 10, "endCol": 2, "interval": 6 },
        {"startRow": 19, "startCol": 12, "endRow": 12, "endCol": 18, "interval": 5 },
    ],
    "checkpoints": {
        "0": 
        [
            "111111111111111111111",
            "111111111111111111111",
            "111111111111111111111",
            "111111111111111111111",
            "111AA1111111111111111",
            "111001111211111111111",
            "111001111211111111111",
            "111100012211111111111",
            "111001010000000001111",
            "111110010!00000001111",
            "111110010010011111111",
            "111110010011011111111",
            "111110000011011111111",
            "111110000000011111111",
            "111111111111111111111",
            "111111111111111111111",
            "111111111111111111111",
            "111111111111111111111",
            "111111111111111111111",
            "111111111111111111111",
            "111111111111111111111",
            
        ]
    }
}