{
    "title": "Double Slit",
    "startGold": 2500,
    "tileset": "ash",
    "route": [
        [ "A", "9" ],
        [ "A", "0", "9" ],
        [ "A", "8" ],
        [ "A", "1", "8" ],
        
    ],
    "field": [
        "11111111111111111111111",
        "11111111111111111111111",
        "11111111101AA1011111111",
        "11111111000000001111111",
        "11111110000000000111111",
        "11111100000000000011111",
        "11111111101111011111111",
        "11111100000000000011111",
        "11111100000000000011111",
        "11111100000000000011111",
        "11111100000000000011111",
        "11111110110110110111111",
        "11111100000000000011111",
        "11111100000000000011111",
        "11111111331111331111111",
        "11111111391111831111111",
        "11111111111111111111111",
        "11111111111111111111111",
        "11111111111111111111111",
    ],
    "checkpoints": {
        "0": 
        [
        "11111111111111111111111",
        "11111111111111111111111",
        "11111111101AA1011111111",
        "11111111000000001111111",
        "11111110000000000111111",
        "11111100000000000011111",
        "11111111101111011111111",
        "11111100000000000011111",
        "11111100000000000011111",
        "11111100000000000011111",
        "11111100000000000011111",
        "1111111!110110110111111",
        "11111111111111111111111",
        "11111111111111111111111",
        "11111111111111111111111",
        "11111111111111111111111",
        "11111111111111111111111",
        "11111111111111111111111",
        "11111111111111111111111",
            
        ],
        "1": 
        [
        "11111111111111111111111",
        "11111111111111111111111",
        "11111111101AA1011111111",
        "11111111000000001111111",
        "11111110000000000111111",
        "11111100000000000011111",
        "11111111101111011111111",
        "11111100000000000011111",
        "11111100000000000011111",
        "11111100000000000011111",
        "11111100000000000011111",
        "1111111011011011!111111",
        "11111111111111111111111",
        "11111111111111111111111",
        "11111111111111111111111",
        "11111111111111111111111",
        "11111111111111111111111",
        "11111111111111111111111",
        "11111111111111111111111",
            
        ]
    }, 
    "decorations": [
        { "type": "Boulder", "row": 16, "col": 14, "rotation": 0 },
        { "type": "Boulder", "row": 16, "col": 9, "rotation": 0 },
    ]
}