{
    "title": "Chambers",
    "startGold": 2000,
    "tileset": "prison",
    "route": [
        [ "A", "9" ],
          
    ],
    "field": [
        
        "1111111111111111111111111111",
        "1111111111111111111111111111",
        "1111AAA111111111111111111111",
        "1111000111111111111111111111",
        "1112000122210000111000021111",
        "11120000000>0000000001022111",
        "1112000011115000111200021111",
        "1111111113331101111110111111",
        "11111100039311V111111V111111",
        "1111110113331101111110111111",
        "1111100011111000001150000111",
        "11111010<0000022200000210111",
        "1111101012221000001102220111",
        "1111100011111111111100000111",
        "1111111111111111111111111111",
        "1111111111111111111111111111",
        "1111111111111111111111111111",
                
    ], 
    "decorations": [
    ]
}