{
    "title": "The Pit",
    "startGold": 1500,
    "tileset": "ice",
    "route": [
        [ "A", "9" ],
        [ "B", "8" ],
    ],
    "field": [
        "111111111111111111111111",
        "111111111111111111111111",
        "111111111111111111111111",
        "111111111110001111111111",
        "111100001000000010000111",
        "111100000020002000000111",
        "111102222222022222220111",
        "111102222220002222220111",
        "111102222220002222220111",
        "111102222220002222220111",
        "111100111122022111100111",
        "111100111000000011100111",
        "111100111011111011100111",
        "1111000B100010001A000111",
        "1111000B111010111A000111",
        "111111111110101111111111",
        "111111111330103311111111",
        "111111111930103811111111",
        "111111111110101111111111",
        "111111111110001111111111",
        "111111111111111111111111",
        "111111111111111111111111",
        "111111111111111111111111",
        "111111111111111111111111"
    ] 
}