{
    "title": "Crumble Zone",
    "startGold": 50000,
    "tileset": "prison",
    "route": [
        [ "A", "9" ],
        [ "B", "9" ],
        [ "C", "7" ],
        [ "A", "8" ]
    ],
    "field": [
        "1111111111111111111111",
        "1001111371222211151511",
        "1111151331222201100001",
        "11BB111101111111101111",
        "1000001102200511101111",
        "1110000000000000002511",
        "1115100111111100150211",
        "1112200111111100000211",
        "1112200111111101010511",
        "115100011AAA1102220111",
        "1000005500000666666661",
        "1011011120010610110111",
        "1011011220511610100122",
        "1011010000111600101122",
        "1011010110111610001111",
        "100000011111111C133101",
        "1111110133311111183101",
        "1111110039311111111111",
        "1111111133311111111111",
        "1111111111111111111111"

    ],
    "rails": [
        { "startRow": 4, "startCol": 13, "endRow": 9, "endCol": 21, "interval": 4 }
    ]
}