{
    "title": "Fortress",
    "startGold": 3000,
    "tileset": "mines",
    "route": [
        [ "A", "9" ],
        [ "B", "9" ],
    ],
    "field": [
        "1111111111111111111111111",
        "1111111111111111111111111",
        "1111111111111111111111111",
        "1111111111111111111111111",
        "1116000161111111610006111",
        "1116110162266622610116111",
        "1116110066661666600116111",
        "1116100011000001100016111",
        "1116001111100011111006111",
        "111620011111V111110026111",
        "11162000A1133311B00026111",
        "11162100A1139311B00126111",
        "11160000A1133311B00006111",
        "1116221111101011111226111",
        "1116666666660666666666111",
        "1111111111161611111111111",
        "1111111111111111111111111",
        "1111111111111111111111111",
        "1111111111111111111111111",
        
    ],
    "rails": [
        {"startRow": 2, "startCol": 11, "endRow": 15, "endCol": 3, "interval": 5 },
        {"startRow": 2, "startCol": 13, "endRow": 15, "endCol": 21, "interval": 5 },
        {"startRow": 15, "startCol": 16, "endRow": 15, "endCol": 8, "interval": 5 },
        
    ], 
}