{
    "title": "Snail",
    "startGold": 100,
    "width": 15,
    "height": 11,
    "route": [
        [ "A", "9" ]
    ],
	"field":[
		"111111111111111",
		"111111111111111",
		"111100000000011",
		"111101111211011",
		"111101111113331",
		"11A000000013931",
		"11A000001003331",
		"111111111121111",
		"111111111221111",
		"111111111121111",
		"111111111111111"
				
	]
}