{
    "title": "Rend",
    "startGold": 3000,
    "tileset": "mines",
    "route": [
        [ "A", "9" ],
        [ "B", "8" ]
    ],
    "field": [
        
        "1111111111111111111111111111111",
        "1111111111111111111111111111111",
        "1111111111111111111111111111111",
        "1111111111100B111A0011111111111",
        "1111111111000B111A0001111111111",
        "1111111110001111111000111111111",
        "1111111100011111111100011111111",
        "1111111000111116211110001111111",
        "1111111005111116211115001111111",
        "1111166666666666000000000111111",
        "1111110000000020200000000111111",
        "1111110000000006666666666611111",
        "1111110001111126111111000111111",
        "1111110001111126111111000111111",
        "1111120011111111111111100211111",
        "1111120011113311133111100211111",
        "11111200000>3911183<00000211111",
        "1111122211111111111111122211111",
        "1111111111111111111111111111111",
        "1111111111111111111111111111111",
        "1111111111111111111111111111111",
        
        
    ], 
    "decorations": [
    ],
    "rails": [
        {"startRow": 11, "startCol": 4, "endRow": 14, "endCol": 15, "interval": 7 },
        {"startRow": 9, "startCol": 26, "endRow": 6, "endCol": 15, "interval": 7 },
        
    ]
}