{
    "title": "Echoing Screams",
    "startGold": 1800,
    "tileset": "prison",
    "route": [
        [ "A", "9" ],
        [ "A", "0", "9" ],
        [ "A", "1", "9" ],
          
    ],
    "field": [
        "11111111111111111111111111111",
        "11111111111111111111111111111",
        "11111111111111111111111111111",
        "11111111111111111111111111111",
        "11111112222222222222221111111",
        "11111222000000000000001111111",
        "1111A000011112222222003331111",
        "1111A000000000000000013931111",
        "1111A000022222221111003331111",
        "11111222000000000000001111111",
        "11111112222222222222221111111",
        "11111111111111111111111111111",
        "11111111111111111111111111111",
        "11111111111111111111111111111",
        "11111111111111111111111111111",
        "11111111111111111111111111111",
                
    ], 
    "decorations": [
    ],
    "checkpoints": {
        "0": 
        [
        "11111111111111111111111111111",
        "11111111111111111111111111111",
        "11111111111111111111111111111",
        "11111111111111111111111111111",
        "11111112222222222222221111111",
        "11111222!00000000000001111111",
        "1111A000011112222222003331111",
        "1111A000010000000000013931111",
        "1111A000022222221111003331111",
        "11111222010000000000001111111",
        "11111112222222222222221111111",
        "11111111111111111111111111111",
        "11111111111111111111111111111",
        "11111111111111111111111111111",
        "11111111111111111111111111111",
        "11111111111111111111111111111",
        
        ],
        "1": 
        [
        "11111111111111111111111111111",
        "11111111111111111111111111111",
        "11111111111111111111111111111",
        "11111111111111111111111111111",
        "11111112222222222222221111111",
        "11111222010000000000001111111",
        "1111A000011112222222003331111",
        "1111A000010000000000013931111",
        "1111A000022222221111003331111",
        "11111222!00000000000001111111",
        "11111112222222222222221111111",
        "11111111111111111111111111111",
        "11111111111111111111111111111",
        "11111111111111111111111111111",
        "11111111111111111111111111111",
        "11111111111111111111111111111",
        
        ]
    }
}