{
    "title": "Dance Dance",
    "startGold": 3000,
    "width": 26,
    "height": 17,
    "route": [
        [ "A", "9" ],
        [ "B", "8" ]
    ],
	"field":[
        "11111111111111111111111111",
        "11111111111111111111111111",
        "11111000011111111111111111",
        "11111011011111111100001111",
        "11A00011011111111101101111",
        "11111111022211111101101111",
        "11111111000211001101333111",
        "11111111110001000001383111",
        "11111111111000001001333111",
        "11111111111011001102111111",
        "11110000011011111102233311",
        "11110222011011111100039311",
        "11110111000011111111133311",
        "11110111111111111111111111",
        "1111B111111111111111111111",
        "11111111111111111111111111",
        "11111111111111111111111111"
	]
}