{
    "title": "The Mountain",
    "startGold": 5000,
    "tileset": "ash",
    "route": [
        [ "A", "9" ],
        [ "A", "8" ],
        [ "B", "7" ],
        [ "C", "7" ]
    ],
    "field": [
        "1111111111111111111111111111111",
        "1111111111111111111111111111111",
        "1111111111111111111111111111111",
        "1111111111111111111111111111111",
        "1111112222111133311112222111111",
        "1111122000B110373011C0002211111",
        "1111220000B100333001C0000221111",
        "111120001111^^111^^111100021111",
        "1111200110000011100000110021111",
        "1111200110010000000100110021111",
        "1111201000010111110100001021111",
        "1111201^100100000001001^1021111",
        "1111200010000011100000100021111",
        "1111200010010011100100100021111",
        "111110101VV100010001VV101011111",
        "1111101010011000001100101011111",
        "1111101011331100011331101011111",
        "11111000119311AAA11381100011111",
        "11111MMM111111111111111MMM11111",
        "1111111111111111111111111111111",
        "1111111111111111111111111111111",
        "1111111111111111111111111111111",
        
    ]
}