{
    "title": "Crossy Track",
    "startGold": 2000,
    "tileset": "mines",
    "route": [
        [ "A", "8" ],
        [ "B", "9" ],
    ],
    "field": [
        "11111111111111111111111",
        "11111111111111111111111",
        "11111111111111111111111",
        "11111111111111111111111",
        "11110000391018300001111",
        "11110000331013300001111",
        "11110011111111111001111",
        "11110011111111111001111",
        "11116666666666666661111",
        "11110120011011002101111",
        "11116666666666666661111",
        "11110102010201020101111",
        "11116666666666666661111",
        "11110110210001201101111",
        "11116666666666666661111",
        "11111022200200222011111",
        "11116666666666666661111",
        "11110100021112000101111",
        "11116666666666666661111",
        "11110011111111111001111",
        "11110000A11511B00001111",
        "11110000A11111B00001111",
        "11111111111111111111111",
        "11111111111111111111111",
        "11111111111111111111111",
       
        
    ],
    "rails": [
        {"startRow": 6, "startCol": 3, "endRow": 6, "endCol": 19, "interval": 4.5 },
        {"startRow": 8, "startCol": 19, "endRow": 8, "endCol": 3, "interval": 4 },
        {"startRow": 10, "startCol": 3, "endRow": 10, "endCol": 19, "interval": 3.5 },
        {"startRow": 12, "startCol": 19, "endRow": 12, "endCol": 3, "interval": 3 },
        {"startRow": 14, "startCol": 3, "endRow": 14, "endCol": 19, "interval": 2.5 },
        {"startRow": 16, "startCol": 19, "endRow": 16, "endCol": 3, "interval": 2 },
    ]
}