{
    "title": "Sewers",
    "startGold": 2000,
    "tileset": "dungeon",
    "route": [
        [ "A", "9" ]
          
    ],
    "field": [
        "1111111111111111111111111111",
        "1111111111111111111111111111",
        "1111111111111111111111111111",
        "111111111111AAA1111111111111",
        "1111200000010001111111111111",
        "1111200000010000000000011111",
        "1111200110010000000000011111",
        "1122200110012222222220022111",
        "1122200110012222222220022111",
        "1111200110000000000000022111",
        "1111200110000000000000022111",
        "1111100222222222221111111111",
        "1111100222222111111333111111",
        "1111100000000000000393111111",
        "1111111222222111111333111111",
        "1111111222222111111111111111",
        "1111111111111111111111111111",
        "1111111111111111111111111111",
        "1111111111111111111111111111",
        "1111111111111111111111111111",
                        
    ], 
    "decorations": [
    ]
}