{
    "title": "Death Spiral",
    "startGold": 2000,
    "tileset": "prison",
    "route": [
        [ "A", "9" ],
        [ "B", "9" ],
    ],
    "field": [
        "11111111111111111111111",
        "11111111111111111111111",
        "11111111111111111111111",
        "11111111111111111111111",
        "11112222000000000001111",
        "11112222000000000001111",
        "11112222022222222001111",
        "11110022021112222001111",
        "111B002201333112200A111",
        "111B002200393002200A111",
        "111B002211333102200A111",
        "11110022221112022001111",
        "11110022222222022221111",
        "11110000000000022221111",
        "11110000000000022221111",
        "11111111111111111111111",
        "11111111111111111111111",
        "11111111111111111111111",
        "11111111111111111111111",
        "11111111111111111111111",
        
    ]
}