{
    "title": "Shallow Grave",
    "startGold": 3000,
    "tileset": "prison",
    "route": [
        [ "A", "9" ],
        [ "B", "8" ],
    ],
    "field": [
        "111111111111111111111111",
        "111111111111111111111111",
        "111111111111111111111111",
        "111111111111111111111111",
        "11111100A100011WWW111111",
        "111111011101011000111111",
        "111331011101011010211111",
        "11183000000000>010211111",
        "111111111101011010211111",
        "11193000000000>010211111",
        "111331011101011010211111",
        "111111011101011000111111",
        "11111100B100011MMM111111",
        "111111111111111111111111",
        "111111111111111111111111",
        "111111111111111111111111",
        "111111111111111111111111"
    ] 
}