{
    "title": "Storage",
    "startGold": 1500,
    "tileset": "mines",
    "route": [
        [ "A", "9" ],
    ],
    "field": [
        "111111111111111111111111",
        "111111111111111111111111",
        "111111111111111111111111",
        "111111111111111611111111",
        "111611111155550655511111",
        "11160000A155505655511111",
        "11660000A155500666661111",
        "111001111111111101011111",
        "111001100010001101011111",
        "111000000000000000000111",
        "111000000000000011010111",
        "111101111000100011010111",
        "111105551101111111010111",
        "111105551105511113310111",
        "1111V1111105511113900111",
        "111100000005511111111111",
        "111122222221111111111111",
        "111111111111111111111111",
        "111111111111111111111111",
        "111111111111111111111111",
        "111111111111111111111111"
    ],
    "rails": [
        {"startRow": 14, "startCol": 20, "endRow": 18, "endCol": 15, "interval": 5 },
        {"startRow": 14, "startCol": 1, "endRow": 17, "endCol": 3, "interval": 4 },
        
    ], 
}