{
    "title": "Hondon",
    "startGold": 2000,
    "tileset": "prison",
    "route": [
        [ "A", "7" ],
        [ "B", "8" ],
        [ "C", "9" ],
          
    ],
    "field": [
        
        "1111111111111111111111111111",
        "1111111111111111111111111111",
        "1111111111111111111111111111",
        "11A0111111111111111111111111",
        "11A00051111111WW11WWW1133111",
        "11A0000000000000000000039111",
        "1111111}20211011011110111111",
        "1111111}20112021022110111111",
        "111B005000000005000500033111",
        "111B000000522000000000038111",
        "111111}0121110{1122010111111",
        "111111}0111220{1221010111111",
        "11C0000000000000000000037111",
        "11C00002111111MMMM1111133111",
        "11C0111111111111111111111111",
        "1111111111111111111111111111",
        "1111111111111111111111111111",
        "1111111111111111111111111111",
                        
    ], 
    "decorations": [
    ]
}