{
    "title": "Balance Test",
    "startGold": 10000,
    "width": 43,
    "height": 8,
    "route": [
        [ "A", "9" ]
    ],
	"field":[
		"1111111111111111111111111111111111111111111",
		"1111111111111111111111111111111111111111111",
		"1111111111111111111111111111111111111113331",
		"11A0000000000000000000000000000000000003931",
		"1111222222222222222222222222222222222223331",
		"1111111121111211112111121111211112111121111",
		"1111111111111111111111111111111111111111111",
		"1111111111111111111111111111111111111111111"	
	]
}