{
    "title": "Snake",
    "startGold": 15000,
    "tileset": "prison",
    "route": [
        [ "A", "8" ],
        [ "B", "8" ],
        [ "A", "9" ],
        [ "B", "9" ],
        [ "C", "9" ],
        [ "C", "8" ]
    ],
    "field": [
        "111111111111111111111111",
        "111111B11111CC1111111111",
        "11A000001111000000001111",
        "11A000051111000000001111",
        "11A001011111000110001111",
        "111111011151010110000011",
        "1111}0000000000111133311",
        "1111}0010050000211139311",
        "1111}0000200002511133311",
        "111111011220002111111111",
        "111121001111001111111111",
        "111120001511000111111111",
        "111111002222000033111111",
        "111111100000000038111111",
        "111111111111111111111111",
        "111111111111111111111111",
        "111111111111111111111111"
    ]
}