{
    "title": "Bottleneck",
    "startGold": 2500,
    "tileset": "stone",
    "route": [
        [ "A", "9" ],
        [ "B", "9" ],
        [ "C", "9" ]
    ],
	"field":[
		"11111111111111111111111",
		"11111111111111111111111",
		"11111111111111111111111",
		"111B000>000111111111111",
		"111B000>000011111111111",
		"11111111010000111111111",
		"111111110>0000011111111",
		"111A000>011000001333111",
		"111A000102100000>393111",
		"111A000>011000001333111",
		"111111110>0000011111111",
		"11111111010000111111111",
		"111C000>000011111111111",
		"111C000>000111111111111",
		"11111111111111111111111",
		"11111111111111111111111",
		"11111111111111111111111",
					
	]
}