{
    "title": "Gateway",
    "startGold": 1500,
    "width": 22,
    "height": 19,
    "route": [
        [ "A", "9" ]
    ],
	"field":[
		"1111111111111111111111",
		"1111111111111111111111",
		"1111111111111111AA1111",
		"1111100021111121002111",
		"1111000000022100000011",
		"1111100010000001100211",
		"111111V111110211120011",
		"1111100011210211221021",
		"1111000110000010000011",
		"1110001111001000000211",
		"1120011100002100121111",
		"111VV11000000101101111",
		"1110000002210002010011",
		"1111000011011111111011",
		"1111110001000001033311",
		"1111110000000000039311",
		"1111111000001100033311",
		"1111111101000001100111",
		"1111111111111111111111",
		"1111111111111111111111",
		"1111111111111111111111"
		
		
	]
}