{
    "title": "Excavation",
    "startGold": 2500,
    "tileset": "stone",
    "route": [
        [ "A", "9" ],
    ],
    "field": [
        "111111111111111111111111",
        "111111111111111111111111",
        "111111111111111111111111",
        "111111111111111111111111",
        "111111111111111101111111",
        "111A00000000000001111111",
        "111A01010001000101111111",
        "111111000000000001111111",
        "111111000100010001111111",
        "111111000000000001111111",
        "111111010001000101111111",
        "111111000000000001111111",
        "111111000100010001111111",
        "111111000000000001111111",
        "111111010001000101331111",
        "111111000000000000391111",
        "111111011111111111111111",
        "111111111111111111111111",
        "111111111111111111111111",
        "111111111111111111111111",
        "111111111111111111111111"
    ],
    "decorations": [
        { "type": "Boulder", "row": 4, "col": 6, "rotation": 180 },
        { "type": "Boulder", "row": 16, "col": 16, "rotation": 0 },
           
    ]
}