{
    "title": "The binding of Jacob",
    "startGold": 15000,
    "tileset": "mines",
    "route": [
        [ "A", "8" ],
        [ "B", "8" ],
        [ "B", "9" ],
        [ "C", "8" ],
        [ "C", "9" ]
    ],
    "field": [
        "111111111111111111111111111111111111111",
        "111111111111111111AAA111111111111111111",
        "110000000000010000000000012200333002211",
        "110022222200015000000000012000383000211",
        "110223332202010011111110012001333100211",
        "110223930002000000000000012001000100211",
        "110223332222010011111110012001000100211",
        "110022222220010000000000512000000000211",
        "110000000000010000000000012200000002211",
        "111111101111111111111111111111101111111",
        "116666660000010222222222016666000000011",
        "110001060100010202252202010016111010011",
        "110010060010010222022022010106010001011",
        "110100060001000202002222000106666601011",
        "110010060010010222022052010100010601011",
        "110001060100010022222220010010111610011",
        "110000066666610000000000010000000666611",
        "111111111111111111101111111111101111111",
        "110002222222212226666622210000000000011",
        "112222222002212206111602210000000000011",
        "1C02222222222120062026002100000000000B1",
        "1C00000022200000062026000000000000000B1",
        "1C02222000002120062026002100222222200B1",
        "112222222222212206111602212222222222211",
        "110200222222012226000622212222222222211",
        "111111111111111111111111111111111111111",
        "111111111111111111111111111111111111111"
    ],
    "rails": [
        { "startRow": 10, "startCol": 13, "endRow": 16, "endCol": 1, "interval": 4 },
        { "startRow": 16, "startCol": 25, "endRow": 10, "endCol": 37, "interval": 5 },
        { "startRow": 2, "startCol": 17, "endRow": 2, "endCol": 21, "interval": 6 }
    ],
    "prebuiltTraps": [
        { "row": 5, "col": 13, "type": "Spike", "tier": 3 },
        { "row": 6, "col": 13, "type": "Dart", "tier": 0, "direction": "Down" }
    ]
}