{
    "title": "Circuit",
    "startGold": 5000,
    "tileset": "prison",
    "route": [
        [ "A", "9" ],
    ],
    "field": [

        "1111111111111111111111111",
        "1111111111111111111111111",
        "1111111111122111111111111",
        "1111111000000000011111111",
        "1111000000000000000011111",
        "1110000000111100000001111",
        "1110000111111111100001111",
        "1110001111111110000001111",
        "111AAA1111111200010001111",
        "1111111111112200110002111",
        "1113331111112200110002111",
        "1113931111112200110002111",
        "1113331111111200010001111",
        "1110001111111110000001111",
        "1110000111111111100001111",
        "1110000000111100000001111",
        "1111000000000000000011111",
        "1111111000000000011111111",
        "1111111111122111111111111",
        "1111111111111111111111111",
        "1111111111111111111111111",
        "1111111111111111111111111",
        "1111111111111111111111111",
           
    ]
}