{
    "title": "Labyrinth",
    "startGold": 3000,
    "tileset": "ice",
    "route": [
        [ "A", "9" ],
    ],
    "field": [
        "11111111111111111111111111",
        "11111111111111111111111111",
        "11111111111111111111111111",
        "11111111111111111111111111",
        "11111100000000000000011111",
        "11111101111000001101011111",
        "11111100000011110011011111",
        "11111100010100000001011111",
        "11330001020101110001000A11",
        "11930101020100010101000A11",
        "11111101020111000101011111",
        "11111101020000010100011111",
        "11111101010122210101011111",
        "11111100000000000001011111",
        "11111111111111111111111111",
        "11111111111111111111111111",
        "11111111111111111111111111",
        "11111111111111111111111111",
        "11111111111111111111111111",
        
    ],
    "decorations": [
        { "type": "Boulder", "row": 5, "col": 18, "rotation": 180 },
        { "type": "Boulder", "row": 14, "col": 6, "rotation": 0 },
        { "type": "Boulder", "row": 14, "col": 13, "rotation": 270 },
        { "type": "Boulder", "row": 6, "col": 10, "rotation": 180 },           
        { "type": "Boulder", "row": 13, "col": 11, "rotation": 270 },  
        { "type": "Boulder", "row": 11, "col": 17, "rotation": 90 }, 
        { "type": "Boulder", "row": 5, "col": 17, "rotation": 90 }, 
    ]
}